#  .  #  #  #
#  .  .  #  #
#  #  .  #  #
#  #  .  #  #
#  #  X  #  #