#  #  #  .  #
#  #  #  .  .
#  #  #  #  .
#  #  .  .  .
#  #  X  #  #