#  #  O  #  #  #  #
#  .  .  #  #  #  #
#  +  #  #  #  #  #
#  .  .  .  +  .  #
#  #  #  #  #  .  #
#  #  #  .  .  .  #
#  #  #  .  #  #  #