#  #  O  #  #  #  #  #
#  .  .  #  #  #  #  #
#  +  #  #  #  #  #  #
#  .  .  .  +  .  #  #
#  #  #  #  #  .  #  #
#  #  #  .  .  .  #  #
#  #  #  .  #  #  #  #
#  #  #  #  #  #  #  #