#  #  #  O  #  #  #  #
#  .  .  .  #  #  #  #
#  +  .  .  #  #  #  #
#  #  #  +  .  .  #  #
#  #  #  #  #  .  #  #
#  #  #  .  .  +  #  #
#  #  #  .  #  #  #  #
#  #  #  #  #  #  #  #