#  #  #  O  #  #  #
#  .  .  .  #  #  #
#  +  .  .  #  #  #
#  #  #  +  .  .  #
#  #  #  #  #  .  #
#  #  #  .  .  +  #
#  #  #  .  #  #  #