#  #  #  O  #  #  #
#  #  #  .  +  .  #
#  +  .  .  #  .  #
#  .  #  #  #  .  #
#  .  .  +  .  .  #
#  #  #  .  #  #  #
#  #  #  .  #  #  #