#  #  #  O  #  #  #  #
#  #  #  .  +  .  #  #
#  +  .  .  #  .  #  #
#  .  #  #  #  .  #  #
#  .  .  +  .  .  #  #
#  #  #  .  #  #  #  #
#  #  #  .  #  #  #  #
#  #  #  #  #  #  #  #