#  #  #  O  #  #  #
#  #  #  .  #  #  #
#  #  #  .  #  #  #
#  #  #  +  #  #  #
#  #  #  .  #  #  #
#  #  #  .  #  #  #
#  #  #  .  #  #  #