#  #  #  O  #  #  #  #
#  #  #  .  #  #  #  #
#  #  #  .  #  #  #  #
#  #  #  +  #  #  #  #
#  #  #  .  #  #  #  #
#  #  #  .  #  #  #  #
#  #  .  .  .  #  #  #
#  #  #  .  #  #  #  #