#  #  #  O  #  #  #  #
#  #  #  .  #  #  #  #
#  #  #  .  #  #  #  #
#  #  #  +  #  #  #  #
#  #  #  .  #  #  #  #
#  #  #  .  #  #  #  #
#  #  #  .  #  #  #  #
#  #  #  #  #  #  #  #